wwwwwwwwwwwwwwwww
w-------&-------w
w---&-------&---w
w---------------w
w---wwwwwwwww---w
w---------------w
w---p---p---p---w
w---------------w
wwwwwwwwwwwwwwwww