wwwwwwwwwwwwwwwww
w---------------w
w---p-------p---w
w-----w-&-w-----w
w------&-&------w
w-----w-&-w-----w
w---p-------p---w
w---------------w
wwwwwwwwwwwwwwwww